#######################
#######################
#######################
#######################
######@..+#+..#+#######
#########.##..#.#######
#######+........#######
#########.###.#########
#######..+###.+.=......
#######################
#######################
#######################
#######################
