#########################################
#########################################
#########################################
#########################################
#########################################
#########################################
############.##+..+.....+###.+..#########
############+####.#############.#########
#######.........#...+-.###.-.+..#########
#######+##.####.#.####.###+##############
#######-##+##.+.#+#.##.#+#.###...+#######
#######.##.######.#.+..#.#.+.#-##########
#######.+....##...######.#.#.#.##########
##########.#-##+######+..-.#.+.##########
##########.#.....+...#####.#.############
########+..#.#####.#######....+##########
############+#+..#+##..+..+#.####+#######
#######......#.###.##-######+####.#######
#######-#+##.#.###.##.#####...+##.#######
#######.#.##+..+..@.+.....#.##-##.#######
#######....#######.####.#.#+##..+.#######
########.#.#######...##.#-####.##########
########.#.-.+..-..#+##+#..+..+##########
########+#.#######+#.##.####.#.##########
########......+###.#-...####.#+##########
########.#####.###.###.##+...#-##########
#######+...+.-..+.-..........#+##########
#########.##########.#+##.##+#.##########
#########-##...+#+...#.##+##...+#########
#########.##+#######.......#.#.##########
#########+##.#####+#.#####.#.#+...#######
#########..+.-.+##.#-#+###-..#.##.#######
#########.####.###.#...###.#.#.##+#######
#########.####.#+#.###.....#+#.##.#######
#########+####.#.#.####.####.#+##.#######
########+##.+.+.+...+##.####.#.##.#######
########.#####.#.#.#.##..+...#.##+#######
########.#####-#.#.#.##.######.##.#######
########.+.....#.#+#.##+.+.-.+.##.#######
##############.+.#.#.############.#######
########.+.......#.#.############.#######
##################=#....+........+#######
##################.######################
##################.######################
##################.######################
##################.######################
##################.######################
##################.######################
