################################
################################
################################
################################
#######...######################
#######@..####...+...##..=......
#######.#+....+#####.##.########
#######.###.#####+##..#..#######
#######-..#.+...#.##.-##.#######
#########.#.###.#...+.##-#######
#######+..#.###+##.##.##.#######
#######.###+...-.+....+..#######
#######.######.######.#.########
#######.#+....+#+.....#.########
#######.#.######.######.########
#######+..-.......+.-..+########
################################
################################
################################
################################